Headword	German_IPA	German_Sound_Classes
weib	v ai p	W V P
korn	k ɔ r n	K V R N
heim	h ai m	H V M
trinken	t r ɪ ŋ k ə n	T R V N K V N
busen	b uː z ə n	P V S V N
sterz	ʃ t ɛ r ts	S T V R K
bock	b ɔ k	P V K
mark	m a r k	M V R K
taube	t au b ə	T V P V
durst	d ʊ r s t	T V R S T
sporn	ʃ p ɔ r n	S P V R N
meinen	m ai n ə n	M V N V N
name	n aː m ə	N V M V
erde	eː r d ə	V R T V
hauen	h au ə n	H V V N
grund	ɡ r ʊ n t	K R V N T
suchen	z uː x ə n	S V K V N
herz	h ɛ r ts	H V R K
vieh	v iː	W V
leim	l ai m	R V M
nadel	n aː d ə l	N V T V R
mahr	m aː r	M V R
graben	ɡ r aː b ə n	K R V P V N
sache	z a x ə	S V K V
fechten	f ɛ x t ə n	P V K T V N
reiten	r ai t ə n	R V T V N
sieben	z iː b ə n	S V P V N
spindel	ʃ p ɪ n d ə l	S P V N T V R
rabe	r aː b ə	R V P V
heilen	h ai l ə n	H V R V N
kalb	k a l p	K V R P
witwe	v ɪ t v ə	W V T W V
gang	ɡ a ŋ	K V N
fahren	f aː r ə n	P V R V N
schwert	ʃ v eː r t	S W V R T
leber	l eː b ə r	R V P V R
wille	v ɪ l ə	W V R V
berg	b ɛ r k	P V R K
drei	d r ai	T R V
wort	v ɔ r t	W V R T
mal	m aː l	M V R
greifen	ɡ r ai f ə n	K R V P V N
fallen	f a l ə n	P V R V N
haupt	h au p t	H V P T
leid	l ai t	R V T
beere	b eː r ə	P V R V
glauben	ɡ l au b ə n	K R V P V N
winter	v ɪ n t ə r	W V N T V R
braut	b r au t	P R V T
spinnen	ʃ p ɪ n ə n	S P V N V N
schild	ʃ ɪ l d/t	S V R T
ball	b a l	P V R
nest	n ɛ s t	N V S T
sterben	ʃ t ɛ r b ə n	S T V R P V N
neun	n ɔy n	N V N
zapfen	ts a pf ə n	K V P V N
salbe	z a l b ə	S V R P V
hund	h ʊ n t	H V N T
fuchs	f ʊ k s	P V K S
denken	d ɛ ŋ k ə n	T V N K V N
dank	d a ŋ k	T V N K
streuen	ʃ t r ɔy ə n	S T R V V N
vier	f iː r	P V R
speer	ʃ p eː r	S P V R
lauge	l au ɡ ə	R V K V
honig	h oː n ɪ x	H V N V K
bohren	b oː r ə n	P V R V N
hecke	h ɛ k ə	H V K V
geburt	ɡ ə b uː r t	K V P V R T
hand	h a n t	H V N T
traum	t r au m	T R V M
laden	l aː d ə n	R V T V N
tier	t iː r	T V R
wal	v aː l	W V R
span	ʃ p aː n	S P V N
tausend	t au z ə n d	T V S V N T
nabel	n aː b ə l	N V P V R
hammer	h a m ə r	H V M V R
falten	f a l t ə n	P V R T V N
stelze	ʃ t ɛ l ts ə	S T V R K V
frost	f r ɔ s t	P R V S T
stehlen	ʃ t eː l ə n	S T V R V N
farn	f a r n	P V R N
netz	n ɛ ts	N V K
bahre	b aː r ə	P V R V
hilfe	h ɪ l f ə	H V R P V
not	n oː t	N V T
hinde	h ɪ n d ə	H V N T V
hasel	h aː z ə l	H V S V R
strang	ʃ t r a ŋ	S T R V N
raum	r au m	R V M
brechen	b r ɛ x ə n	P R V K V N
bruch	b r ʊ x	P R V K
otter	ɔ t ə r	V T V R
saum	z au m	S V M
bann	b a n	P V N
leuchten	l ɔy x t ə n	R V K T V N
handeln	h a n d ə l n	H V N T V R N
knopf	k n ɔ pf	K N V P
bieten	b iː t ə n	P V T V N
donner	d ɔ n ə r	T V N V R
klimmen	k l ɪ m ə n	K R V M V N
garn	ɡ a r n	K V R N
tat	t aː t	T V T
binden	b ɪ n d ə n	P V N T V N
schulter	ʃ ʊ l t ə r	S V R T V R
ein	ai n	V N
leben	l eː b ə n	R V P V N
gift	ɡ ɪ f t	K V P T
horn	h ɔ r n	H V R N
nabe	n aː b ə	N V P V
helm	h ɛ l m	H V R M
wagen	v aː ɡ ə n	W V K V N
beide	b ai d ə	P V T V
dieb	d iː p	T V P
waten	v aː t ə n	W V T V N
wetter	v ɛ t ə r	W V T V R
laub	l au p	R V P
milch	m ɪ l x	M V R K
sturm	ʃ t ʊ r m	S T V R M
waffe	v a f ə	W V P V
ochse	ɔ k s ə	V K S V
wachsen	v a k s ə n	W V K S V N
feld	f ɛ l t	P V R T
wald	v a l t	W V R T
rauch	r au x	R V K
ding	d ɪ ŋ	T V N
mut	m uː t	M V T
schaufel	ʃ au f ə l	S V P V R
strecken	ʃ t r ɛ k ə n	S T R V K V N
rost	r ɔ s t	R V S T
trank	t r a ŋ k	T R V N K
galle	ɡ a l ə	K V R V
geben	ɡ eː b ə n	K V P V N
hag	h aː k	H V K
monat	m oː n aː t	M V N V T
teig	t ai k	T V K
knecht	k n ɛ x t	K N V K T
aal	aː l	V R
volk	f ɔ l k	P V R K
tag	t aː k	T V K
lauch	l au x	R V K
gras	ɡ r aː s	K R V S
brand	b r a n t	P R V N T
heu	h ɔy	H V
boden	b oː d ə n	P V T V N
joch	j ɔ x	J V K
sparen	ʃ p aː r ə n	S P V R V N
leib	l ai p	R V P
wachs	v a k s	W V K S
blut	b l uː t	P R V T
zehn	ts eː n	K V N
jugend	j uː ɡ ə n t	J V K V N T
regenbogen	r eː ɡ ə n b oː ɡ ə n	R V K V N P V K V N
kropf	k r ɔ pf	K R V P
futter	f ʊ t ə r	P V T V R
lunge	l ʊ ŋ ə	R V N V
dill	d/t ɪ l	T V R
winden	v ɪ n d ə n	W V N T V N
lehm	l eː m	R V M
knie	k n iː	K N V
vater	f aː t ə r	P V T V R
lassen	l a s ə n	R V S V N
frieren	f r iː r ə n	P R V R V N
biegen	b iː ɡ ə n	P V K V N
buch	b uː x	P V K
segel	z eː ɡ ə l	S V K V R
leine	l ai n ə	R V N V
dach	d a x	T V K
furche	f ʊ r x ə	P V R K V
zeit	ts ai t	K V T
floh	f l oː	P R V
saft	z a f t	S V P T
zecke	ts ɛ k ə	K V K V
schwimmen	ʃ v ɪ m ə n	S W V M V N
malz	m a l ts	M V R K
kauen	k au ə n	K V V N
ringen	r ɪ ŋ ə n	R V N V N
waschen	v a ʃ ə n	W V S V N
hagel	h aː ɡ ə l	H V K V R
ofen	oː f ə n	V P V N
jahr	j aː r	J V R
fleisch	f l ai ʃ	P R V S
bauer	b au ə r	P V V R
bein	b ai n	P V N
wachen	v a x ə n	W V K V N
wunder	v ʊ n d ə r	W V N T V R
schwester	ʃ v ɛ s t ə r	S W V S T V R
schnee	ʃ n eː	S N V
lachen	l a x ə n	R V K V N
regen	r eː ɡ ə n	R V K V N
himmel	h ɪ m ə l	H V M V R
schwein	ʃ v ai n	S W V N
teil	t ai l	T V R
gold	ɡ ɔ l t	K V R T
kuh	k uː	K V
sorge	z ɔ r ɡ ə	S V R K V
fliegen	f l iː ɡ ə n	P R V K V N
scheide	ʃ ai d ə	S V T V
widder	v ɪ d ə r	W V T V R
wurm	v ʊ r m	W V R M
wasser	v a s ə r	W V S V R
brauchen	b r au x ə n	P R V K V N
schlagen	ʃ l aː ɡ ə n	S R V K V N
locke	l ɔ k ə	R V K V
beginnen	b ə ɡ ɪ n ə n	P V K V N V N
brot	b r oː t	P R V T
sechs	z ɛ k s	S V K S
nacken	n a k ə n	N V K V N
warze	v a r ts ə	W V R K V
bart	b aː r t	P V R T
tal	t aː l	T V R
sitzen	z ɪ ts ə n	S V K V N
zange	ts a ŋ ə	K V N V
salz	z a l ts	S V R K
fliehen	f l iː ə n	P R V V N
sparren	ʃ p a r ə n	S P V R V N
hure	h uː r ə	H V R V
treiben	t r ai b ə n	T R V P V N
kitt	k ɪ t	K V T
halten	h a l t ə n	H V R T V N
stroh	ʃ t r oː	S T R V
fisch	f ɪ ʃ	P V S
weide	v ai d ə	W V T V
wespe	v ɛ s p ə	W V S P V
schwalbe	ʃ v a l b ə	S W V R P V
schauen	ʃ au ə n	S V V N
gans	ɡ a n s	K V N S
beugen	b ɔy ɡ ə n	P V K V N
bord	b ɔ r d/t	P V R T
reif	r ai f	R V P
bad	b aː d	P V T
fasten	f a s t ə n	P V S T V N
westen	v ɛ s t ə n	W V S T V N
seele	z eː l ə	S V R V
lust	l ʊ s t	R V S T
essen	ɛ s ə n	V S V N
haben	h aː b ə n	H V P V N
haar	h aː r	H V R
dreschen	d r ɛ ʃ ə n	T R V S V N
land	l a n t	R V N T
spannen	ʃ p a n ə n	S P V N V N
strom	ʃ t r oː m	S T R V M
saufen	z au f ə n	S V P V N
schaf	ʃ aː f	S V P
senden	z ɛ n d ə n	S V N T V N
ruck	r ʊ k	R V K
zaum	ts au m	K V M
verlieren	f ɛ r l iː r ə n	P V R R V R V N
stillen	ʃ t ɪ l ə n	S T V R V N
scheinen	ʃ ai n ə n	S V N V N
stab	ʃ t aː p	S T V P
flut	f l uː t	P R V T
stein	ʃ t ai n	S T V N
bogen	b oː ɡ ə n	P V K V N
scheren	ʃ eː r ə n	S V R V N
backen	b a k ə n	P V K V N
leiste	l ai s t ə	R V S T V
schieben	ʃ iː b ə n	S V P V N
helfen	h ɛ l f ə n	H V R P V N
bitten	b ɪ t ə n	P V T V N
machen	m a x ə n	M V K V N
roggen	r ɔ ɡ ə n	R V K V N
wolle	v ɔ l ə	W V R V
see	z eː	S V
wiesel	v iː z ə l	W V S V R
spreiten	ʃ p r ai t ə n	S P R V T V N
kraft	k r a f t	K R V P T
herd	h eː r t	H V R T
tau	t au	T V
wolf	v ɔ l f	W V R P
herbst	h ɛ r p s t	H V R P S T
nacht	n a x t	N V K T
lappen	l a p ə n	R V P V N
welt	v ɛ l t	W V R T
werfen	v ɛ r f ə n	W V R P V N
singen	z ɪ ŋ ə n	S V N V N
macht	m a x t	M V K T
nagel	n aː ɡ ə l	N V K V R
tun	t uː n	T V N
feuer	f ɔy ə r	P V V R
zeichen	ts ai x ə n	K V K V N
lecken	l ɛ k ə n	R V K V N
sengen	z ɛ ŋ ə n	S V N V N
gast	ɡ a s t	K V S T
mutter	m ʊ t ə r	M V T V R
stamm	ʃ t a m	S T V M
bast	b a s t	P V S T
lid	l iː t	R V T
raten	r aː t ə n	R V T V N
bringen	b r ɪ ŋ ə n	P R V N V N
sondern	z ɔ n d ə r n	S V N T V R N
dorn	d ɔ r n	T V R N
wollen	v ɔ l ə n	W V R V N
schlafen	ʃ l aː f ə n	S R V P V N
ruder	r uː d ə r	R V T V R
zunge	ts ʊ ŋ ə	K V N V
kamm	k a m	K V M
treten	t r eː t ə n	T R V T V N
balg	b a l k	P V R K
freund	f r ɔy n t	P R V N T
finger	f ɪ ŋ ə r	P V N V R
mast	m a s t	M V S T
distel	d ɪ s t ə l	T V S T V R
zehe	ts eː ə	K V V
linde	l ɪ n d ə	R V N T V
nase	n aː z ə	N V S V
reh	r eː	R V
zaun	ts au n	K V N
leiten	l ai t ə n	R V T V N
sieb	z iː p	S V P
bersten	b ɛ r s t ə n	P V R S T V N
sonne	z ɔ n ə	S V N V
finden	f ɪ n d ə n	P V N T V N
werft	v ɛ r f t	W V R P T
brust	b r ʊ s t	P R V S T
halle	h a l ə	H V R V
weile	v ai l ə	W V R V
habicht	h aː b ɪ x t	H V P V K T
fell	f ɛ l	P V R
flachs	f l a k s	P R V K S
schmieren	ʃ m iː r ə n	S M V R V N
setzen	z ɛ ts ə n	S V K V N
laus	l au s	R V S
faust	f au s t	P V S T
vogel	f oː ɡ ə l	P V K V R
kneten	k n eː t ə n	K N V T V N
biber	b iː b ə r	P V P V R
schaft	ʃ a f t	S V P T
sommer	z ɔ m ə r	S V M V R
gott	ɡ ɔ t	K V T
weg	v eː k	W V K
folgen	f ɔ l ɡ ə n	P V R K V N
huf	h uː f	H V P
stuhl	ʃ t uː l	S T V R
stock	ʃ t ɔ k	S T V K
schleim	ʃ l ai m	S R V M
mann	m a n	M V N
weben	v eː b ə n	W V P V N
